people - люди;
family - семья;
woman - женщина;
man - мужчина;
girl - девочка;
boy - мальчик;
child - ребёнок;
friend - друг;
husband - муж;
wife - жена;
name - имя;
head - голова;
face - лицо;
hand - рука;
life - жизнь;
hour - час;
week - неделя;
day - день;
night - ночь;
month - месяц;
year - год;
time - время;
world - мир;
sun - солнце;
animal - животное;
tree - дерево;
water - вода;
food - еда;
fire - огонь;
country - страна;
city - город;
street - улица;
work - работа,работать;
school - школа;
shop - магазин;
house - дом;
room - комната;
car - машина;
paper - бумага;
pen - ручка;
door - дверь;
chair - стул;
table - стол;
money - деньги;
way - путь;
end - конец;
price - цена;
question - вопрос;
answer - ответ,ответить;
number - номер;
be - быть;
have - иметь;
do - делать;
get - получать;
can - мочь;
feel - чувствовать;
live - жить;
love - любить;
want - хотеть;
say - сказать;
tell - говорить;
see - видеть;
hear - слышать;
listen - слушать;
believe - верить;
take - брать;
give - давать;
go - идти;
run - бежать;
walk - гулять;
come - приходить;
leave - покидать;
sit - сидеть;
stand - стоять;
make - делать;
know - знать;
understand - понимать;
remember - помнить;
think - думать;
bring - приносить;
find - находить;
lose - терять;
use - использовать;
study - учиться;
learn - учить;
ask - спрашивать;
let - позволять;
help - помогать;
begin - начинать;
play - играть;
write - писать;
read - читать;
turn - поворачивать;
meet - встретить;
change - изменить;
stop - останавливать;
open - открыть,открытый;
close - закрыть;
always - всегда;
never - никогда;
also - также;
only - только;
again - опять;
often - часто;
still - всё ещё;
already - уже;
almost - почти;
enough - достаточно;
very - очень;
sometimes - иногда;
now - сейчас;
then - тогда;
usually - обычно;
quickly - быстро;
slowly - медленно;
well - хорошо;
especially - особенно;
good - хороший;
bad - плохой;
new - новый;
young - молодой;
old - старый;
big - большой;
small - маленький;
long - длинный;
low - низкий;
high - высокий;
strong - сильный;
free - свободный;
easy - лёгкий;
right - верный;
wrong - неверный;
hot - горячий;
cold - холодный;
happy - счастливый;
ready - готовый;